type octile
height 13
width 34
map
##################################
#................................#
#................................#
#......................####......#
#.....................#####......#
#.....................#####......#
#................................#
#................................#
#................................#
#................................#
#................................#
#................................#
##################################
