type octile
height 9
width 12
map
............
...#........
...#........
...#....##..
........#...
........#...
........#...
..#.....#...
........#...
