type octile
height 6
width 6
map
TTTTTT
T....T
T....T
T..T.T
T....T
TTTTTT
