type octile
height 12
width 12
map
TTTTTTTTTTTT
T..........T
T..........T
T..........T
T..........T
T..........T
T..........T
T..........T
T..........T
T..........T
T..........T
TTTTTTTTTTTT
